6,5,4,5,4,3,4,5
5,4,3,4,3,2,3,4
4,3,2,3,2,1,2,3
5,4,3,4,3,2,3,4
4,3,2,3,2,1,2,3
3,2,1,2,1,0,1,2
4,3,2,3,2,1,2,3
5,4,3,4,3,2,3,4
